border_size=1
usage=map

Chw         , Chw         , Chw         , Chw         , Chw         , Chw         , Wo          , Wo          , Wo          , Wo          , Wo          , Wo          , Wo          , Wo          , Wo          , Wo          , Wo          , Wo          , Wo          , Wo          , Wo          , Wo          , Wo          , Wo          , Wo          , Wo          , Wo          , Wo          , Wo          , Wo          , Wo          , Wo          , Wo          , Wo          , Wo          , Wo          , Wo          , Wo          , Wo          , Wo          , Wo          , Wo          , Wo          , Wo          , Wo          , Wo          , Wo          , Wo          , Wo          , Wo          , Wo          , Wo          , Wo          , Wo          , Wo          , Wo          , Wo          , Wo          , Wo          , Wo          , Wo          , Wo          , Wo          , Wo          
Chw         , Chw         , Chw         , Chw         , Chw         , Chw         , Wo          , Wo          , Wo^Bw/      , Wo          , Wo          , Wo          , Wo          , Wo          , Wo          , Wo          , Wo          , Wo          , Wo          , Wo          , Wo          , Wo          , Wo          , Wo          , Wo          , Wo          , Wo          , Wo          , Wo          , Wo          , Wo          , Wo          , Wo          , Wo          , Wo          , Wo          , Wo          , Wo          , Wo          , Wo          , Wo          , Wo          , Wo          , Wo          , Wo          , Wo          , Wo          , Wo          , Wo          , Wo          , Wo          , Wo          , Wo          , Wo          , Wo          , Wo          , Wo          , Wo          , Wo          , Wo          , Wo          , Wo          , Wo          , Wo          
Chw         , Chw         , Chw         , Chw         , Chw         , Chw         , Wo          , Rp          , Wo^Bw\      , Wo          , Wo          , Wo          , Wo          , Wo          , Wo          , Wo          , Wo          , Wo          , Wo          , Wo          , Wo          , Wo          , Wo          , Wo          , Wo          , Wo          , Wo          , Wo          , Wo          , Wo          , Wo          , Wo          , Wo          , Wo          , Wo          , Wo          , Wo          , Wo          , Wo          , Wo          , Wo          , Wo          , Wo          , Wo          , Wo          , Wo          , Wo          , Wo          , Wo          , Wo          , Wo          , Wo          , Wo          , Wo          , Wo          , Wo          , Wo          , Wo          , Wo          , Wo          , Wo          , Wo          , Wo          , Wo          
Chw         , Chw         , Chw         , Chw         , Chw         , Chw         , Wo          , Wo          , Wo          , Wo          , Wo          , Wo          , Wo          , Wo^Bw|      , Wo          , Wo          , Wo          , Wo^Bw|      , Wo          , Wo          , Wo          , Wo^Bw|      , Wo          , Wo          , Wo          , Wo^Bw|      , Wo          , Wo          , Wo          , Wo^Bw|      , Wo          , Wo          , Wo          , Wo^Bw|      , Wo          , Wo          , Wo          , Wo          , Wo          , Wo^Bw|      , Wo          , Wo          , Wo          , Wo^Bw|      , Wo          , Wo          , Wo          , Wo^Bw|      , Wo          , Wo          , Wo          , Wo^Bw|      , Wo          , Wo          , Wo          , Wo^Bw|      , Wo          , Wo          , Wo          , Wo^Bw|      , Wo          , Wo          , Wo          , Wo          
Wo          , Wo          , Wo          , Wo          , Wo          , Wo          , Wo          , Wo          , Ce          , Ce          , Wo          , Wo          , Wo          , Rp          , Wo          , Wo          , Wo          , Rp          , Wo          , Wo          , Wo          , Rp          , Wo          , Wo          , Wo          , Rp          , Wo          , Wo          , Wo          , Rp          , Wo          , Wo          , Wo          , Rp          , Wo          , Wo          , Wo          , Wo          , Wo          , Rp          , Wo          , Wo          , Wo          , Rp          , Wo          , Wo          , Wo          , Rp          , Wo          , Wo          , Wo          , Rp          , Wo          , Wo          , Wo          , Rp          , Wo          , Wo          , Wo          , Rp          , Wo          , Wo          , Wo          , Wo          
Wo          , Wo          , Wo          , Wo          , Wo          , Wo          , Wo          , Wo          , Ce          , Ce          , Wo          , Wo          , Wo          , Wo^Bw|      , Wo          , Wo          , Wo          , Wo^Bw|      , Wo          , Wo          , Wo          , Wo^Bw|      , Wo          , Wo          , Wo          , Wo^Bw|      , Wo          , Wo          , Wo          , Wo^Bw|      , Wo          , Wo          , Wo          , Wo^Bw|      , Wo          , Wo          , Wo          , Wo          , Wo          , Wo^Bw|      , Wo          , Wo          , Wo          , Wo^Bw|      , Wo          , Wo          , Wo          , Wo^Bw|      , Wo          , Wo          , Wo          , Wo^Bw|      , Wo          , Wo          , Wo          , Wo^Bw|      , Wo          , Wo          , Wo          , Wo^Bw|      , Wo          , Wo          , Wo          , Wo          
Gs^Fp       , Gs^Fp       , Gs^Fp       , Wo          , Wo          , Wo          , Wo          , Wo          , Ce          , Ce          , Wo          , Wo          , Ch          , Wo          , Ch          , Wo          , Cud         , Wo          , Cud         , Wo          , Ch          , Wo          , Ch          , Wo          , Cud         , Wo          , Cud         , Wo          , Ch          , Wo          , Ch          , Wo          , Cud         , Wo          , Cud         , Wo          , Wo          , Wo          , Ch          , Wo          , Ch          , Wo          , Cud         , Wo          , Cud         , Wo          , Ch          , Wo          , Ch          , Wo          , Cud         , Wo          , Cud         , Wo          , Ch          , Wo          , Ch          , Wo          , Cud         , Wo          , Cud         , Wo          , Wo          , Wo          
Gs^Fp       , Gs^Fp       , Gs^Fp       , Wo          , Wo          , Wo          , Kh          , Wo          , Ce          , Ce          , Wo          , Wo          , Ch          , Ch          , Ch          , Wo          , Cud         , Cud         , Cud         , Wo          , Ch          , Ch          , Ch          , Wo          , Cud         , Cud         , Cud         , Wo          , Ch          , Ch          , Ch          , Wo          , Cud         , Cud         , Cud         , Wo          , Wo          , Wo          , Ch          , Ch          , Ch          , Wo          , Cud         , Cud         , Cud         , Wo          , Ch          , Ch          , Ch          , Wo          , Cud         , Cud         , Cud         , Wo          , Ch          , Ch          , Ch          , Wo          , Cud         , Cud         , Cud         , Wo          , Wo          , Wo          
Gs^Fp       , Gs^Fp       , Gs^Fp       , Gg          , Wo^Bw/      , Wo^Bw/      , Wo          , Wo          , Ce          , Ce          , Wo          , Wo          , Ch          , Ch          , Ch          , Wo          , Cud         , Cud         , Cud         , Wo          , Ch          , Ch          , Ch          , Wo          , Cud         , Cud         , Cud         , Wo          , Ch          , Ch          , Ch          , Wo          , Cud         , Cud         , Cud         , Wo          , Wo          , Wo          , Ch          , Ch          , Ch          , Wo          , Cud         , Cud         , Cud         , Wo          , Ch          , Ch          , Ch          , Wo          , Cud         , Cud         , Cud         , Wo          , Ch          , Ch          , Ch          , Wo          , Cud         , Cud         , Cud         , Wo          , Wo          , Wo          
Gs^Fp       , Gs^Fp       , Gs^Fp       , Gs^Fp       , Wo          , Wo          , Wo          , Wo          , Ce          , Ce          , Wo          , Wo          , Ch          , Ch          , Ch          , Wo          , Cud         , Cud         , Cud         , Wo          , Ch          , Ch          , Ch          , Wo          , Cud         , Cud         , Cud         , Wo          , Ch          , Ch          , Ch          , Wo          , Cud         , Cud         , Cud         , Wo          , Wo          , Wo          , Ch          , Ch          , Ch          , Wo          , Cud         , Cud         , Cud         , Wo          , Ch          , Ch          , Ch          , Wo          , Cud         , Cud         , Cud         , Wo          , Ch          , Ch          , Ch          , Wo          , Cud         , Cud         , Cud         , Wo          , Wo          , Wo          
Gs^Fp       , Gs^Fp       , Gs^Fp       , Gs^Fp       , Gs^Fp       , Wo          , Wo          , Wo          , Ce          , Ce          , Wo          , Wo          , Ch          , Ch          , Ch          , Wo          , Cud         , Cud         , Cud         , Wo          , Ch          , Ch          , Ch          , Wo          , Cud         , Cud         , Cud         , Wo          , Ch          , Ch          , Ch          , Wo          , Cud         , Cud         , Cud         , Wo          , Wo          , Wo          , Ch          , Ch          , Ch          , Wo          , Cud         , Cud         , Cud         , Wo          , Ch          , Ch          , Ch          , Wo          , Cud         , Cud         , Cud         , Wo          , Ch          , Ch          , Ch          , Wo          , Cud         , Cud         , Cud         , Wo          , Wo          , Wo          
Gs^Fp       , Gs^Fp       , Gs^Fp       , Gs^Fp       , Gs^Fp       , Wo          , Wo          , Wo          , Wo          , Ce          , Wo          , Wo          , Wo          , Ch          , Wo          , Wo          , Wo          , Cud         , Wo          , Wo          , Wo          , Ch          , Wo          , Wo          , Wo          , Cud         , Wo          , Wo          , Wo          , Ch          , Wo          , Wo          , Wo          , Cud         , Wo          , Wo          , Wo          , Wo          , Wo          , Ch          , Wo          , Wo          , Wo          , Cud         , Wo          , Wo          , Wo          , Ch          , Wo          , Wo          , Wo          , Cud         , Wo          , Wo          , Wo          , Ch          , Wo          , Wo          , Wo          , Cud         , Wo          , Wo          , Wo          , Wo          
Gs^Fp       , Gs^Fp       , Gs^Fp       , Gs^Fp       , Gs^Fp       , Wo          , Wo          , Wo          , Wo          , Wo          , Wo          , Wo          , Wo          , Wo          , Wo          , Wo          , Wo          , Wo          , Wo          , Wo          , Wo          , Wo          , Wo          , Wo          , Wo          , Wo          , Wo          , Wo          , Wo          , Wo          , Wo          , Wo          , Wo          , Wo          , Wo          , Wo          , Wo          , Wo          , Wo          , Wo          , Wo          , Wo          , Wo          , Wo          , Wo          , Wo          , Wo          , Wo          , Wo          , Wo          , Wo          , Wo          , Wo          , Wo          , Wo          , Wo          , Wo          , Wo          , Wo          , Wo          , Wo          , Wo          , Wo          , Wo          
Gs^Fp       , Gs^Fp       , Gs^Fp       , Gs^Fp       , Wo          , Wo          , Wo          , Wo          , Ce          , Ce          , Wo          , Wo          , Cud         , Cud         , Cud         , Wo          , Ch          , Ch          , Ch          , Wo          , Cud         , Cud         , Cud         , Wo          , Ch          , Ch          , Ch          , Wo          , Cud         , Cud         , Cud         , Wo          , Ch          , Ch          , Ch          , Wo          , Wo          , Wo          , Cud         , Cud         , Cud         , Wo          , Ch          , Ch          , Ch          , Wo          , Cud         , Cud         , Cud         , Wo          , Ch          , Ch          , Ch          , Wo          , Cud         , Cud         , Cud         , Wo          , Ch          , Ch          , Ch          , Wo          , Wo          , Wo          
Gs^Fp       , Gs^Fp       , Gs^Fp       , Gs^Fp       , Wo          , Wo          , Wo          , Wo          , Ce          , Ce          , Wo          , Wo          , Cud         , Cud         , Cud         , Wo          , Ch          , Ch          , Ch          , Wo          , Cud         , Cud         , Cud         , Wo          , Ch          , Ch          , Ch          , Wo          , Cud         , Cud         , Cud         , Wo          , Ch          , Ch          , Ch          , Wo          , Wo          , Wo          , Cud         , Cud         , Cud         , Wo          , Ch          , Ch          , Ch          , Wo          , Cud         , Cud         , Cud         , Wo          , Ch          , Ch          , Ch          , Wo          , Cud         , Cud         , Cud         , Wo          , Ch          , Ch          , Ch          , Wo          , Wo          , Wo          
Gs^Fp       , Gs^Fp       , Gs^Fp       , Gs^Fp       , Wo^Bw\      , Wo          , Wo          , Wo          , Ce          , Ce          , Wo          , Wo          , Cud         , Cud         , Cud         , Wo          , Ch          , Ch          , Ch          , Wo          , Cud         , Cud         , Cud         , Wo          , Ch          , Ch          , Ch          , Wo          , Cud         , Cud         , Cud         , Wo          , Ch          , Ch          , Ch          , Wo          , Wo          , Wo          , Cud         , Cud         , Cud         , Wo          , Ch          , Ch          , Ch          , Wo          , Cud         , Cud         , Cud         , Wo          , Ch          , Ch          , Ch          , Wo          , Cud         , Cud         , Cud         , Wo          , Ch          , Ch          , Ch          , Wo          , Wo          , Wo          
Gs^Fp       , Gs^Fp       , Gs^Fp       , Gg          , Wo          , Wo^Bw\      , Kh          , Wo          , Ce          , Ce          , Wo          , Wo          , Cud         , Cud         , Cud         , Wo          , Ch          , Ch          , Ch          , Wo          , Cud         , Cud         , Cud         , Wo          , Ch          , Ch          , Ch          , Wo          , Cud         , Cud         , Cud         , Wo          , Ch          , Ch          , Ch          , Wo          , Wo          , Wo          , Cud         , Cud         , Cud         , Wo          , Ch          , Ch          , Ch          , Wo          , Cud         , Cud         , Cud         , Wo          , Ch          , Ch          , Ch          , Wo          , Cud         , Cud         , Cud         , Wo          , Ch          , Ch          , Ch          , Wo          , Wo          , Wo          
Gs^Fp       , Gs^Fp       , Wo          , Wo          , Wo          , Wo          , Wo          , Wo          , Ce          , Ce          , Wo          , Wo          , Cud         , Cud         , Cud         , Wo          , Ch          , Ch          , Ch          , Wo          , Cud         , Cud         , Cud         , Wo          , Ch          , Ch          , Ch          , Wo          , Cud         , Cud         , Cud         , Wo          , Ch          , Ch          , Ch          , Wo          , Wo          , Wo          , Cud         , Cud         , Cud         , Wo          , Ch          , Ch          , Ch          , Wo          , Cud         , Cud         , Cud         , Wo          , Ch          , Ch          , Ch          , Wo          , Cud         , Cud         , Cud         , Wo          , Ch          , Ch          , Ch          , Wo          , Wo          , Wo          
Gs^Fp       , Gs^Fp       , Wo          , Wo          , Wo          , Wo          , Wo          , Wo          , Ce          , Ce          , Wo          , Wo          , Wo          , Wo          , Wo          , Wo          , Wo          , Wo          , Wo          , Wo          , Wo          , Wo          , Wo          , Wo          , Wo          , Wo          , Wo          , Wo          , Wo          , Wo          , Wo          , Wo          , Wo          , Wo          , Wo          , Wo          , Wo          , Wo          , Wo          , Wo          , Wo          , Wo          , Wo          , Wo          , Wo          , Wo          , Wo          , Wo          , Wo          , Wo          , Wo          , Wo          , Wo          , Wo          , Wo          , Wo          , Wo          , Wo          , Wo          , Wo          , Wo          , Wo          , Wo          , Wo          
Wo          , Wo          , Wo          , Wo          , Wo          , Wo          , Wo          , Wo          , Ce          , Ce          , Wo          , Wo          , Wo          , Wo^Bw|      , Wo          , Wo          , Wo          , Wo^Bw|      , Wo          , Wo          , Wo          , Wo^Bw|      , Wo          , Wo          , Wo          , Wo^Bw|      , Wo          , Wo          , Wo          , Wo^Bw|      , Wo          , Wo          , Wo          , Wo^Bw|      , Wo          , Wo          , Wo          , Wo          , Wo          , Wo^Bw|      , Wo          , Wo          , Wo          , Wo^Bw|      , Wo          , Wo          , Wo          , Wo^Bw|      , Wo          , Wo          , Wo          , Wo^Bw|      , Wo          , Wo          , Wo          , Wo^Bw|      , Wo          , Wo          , Wo          , Wo^Bw|      , Wo          , Wo          , Wo          , Wo          
Wo          , Wo          , Wo          , Wo          , Wo          , Wo          , Wo          , Wo          , Wo          , Ce          , Wo          , Wo          , Wo          , Rp          , Wo          , Wo          , Wo          , Rp          , Wo          , Wo          , Wo          , Rp          , Wo          , Wo          , Wo          , Rp          , Wo          , Wo          , Wo          , Rp          , Wo          , Wo          , Wo          , Rp          , Wo          , Wo          , Wo          , Wo          , Wo          , Rp          , Wo          , Wo          , Wo          , Rp          , Wo          , Wo          , Wo          , Rp          , Wo          , Wo          , Wo          , Rp          , Wo          , Wo          , Wo          , Rp          , Wo          , Wo          , Wo          , Rp          , Wo          , Wo          , Wo          , Wo          
Chw         , Chw         , Chw         , Chw         , Chw         , Chw         , Wo          , Wo          , Wo^Bw/      , Wo          , Wo          , Wo          , Wo          , Wo^Bw|      , Wo          , Wo          , Wo          , Wo^Bw|      , Wo          , Wo          , Wo          , Wo^Bw|      , Wo          , Wo          , Wo          , Wo^Bw|      , Wo          , Wo          , Wo          , Wo^Bw|      , Wo          , Wo          , Wo          , Wo^Bw|      , Wo          , Wo          , Wo          , Wo          , Wo          , Wo^Bw|      , Wo          , Wo          , Wo          , Wo^Bw|      , Wo          , Wo          , Wo          , Wo^Bw|      , Wo          , Wo          , Wo          , Wo^Bw|      , Wo          , Wo          , Wo          , Wo^Bw|      , Wo          , Wo          , Wo          , Wo^Bw|      , Wo          , Wo          , Wo          , Wo          
Chw         , Chw         , Chw         , Chw         , Chw         , Chw         , Wo          , Rp          , Wo^Bw\      , Wo          , Wo          , Wo          , Wo          , Wo          , Wo          , Wo          , Wo          , Wo          , Wo          , Wo          , Wo          , Wo          , Wo          , Wo          , Wo          , Wo          , Wo          , Wo          , Wo          , Wo          , Wo          , Wo          , Wo          , Wo          , Wo          , Wo          , Wo          , Wo          , Wo          , Wo          , Wo          , Wo          , Wo          , Wo          , Wo          , Wo          , Wo          , Wo          , Wo          , Wo          , Wo          , Wo          , Wo          , Wo          , Wo          , Wo          , Wo          , Wo          , Wo          , Wo          , Wo          , Wo          , Wo          , Wo          
Chw         , Chw         , Chw         , Chw         , Chw         , Chw         , Wo          , Wo          , Wo          , Wo          , Wo          , Wo          , Wo          , Wo          , Wo          , Wo          , Wo          , Wo          , Wo          , Wo          , Wo          , Wo          , Wo          , Wo          , Wo          , Wo          , Wo          , Wo          , Wo          , Wo          , Wo          , Wo          , Wo          , Wo          , Wo          , Wo          , Wo          , Wo          , Wo          , Wo          , Wo          , Wo          , Wo          , Wo          , Wo          , Wo          , Wo          , Wo          , Wo          , Wo          , Wo          , Wo          , Wo          , Wo          , Wo          , Wo          , Wo          , Wo          , Wo          , Wo          , Wo          , Wo          , Wo          , Wo          
Chw         , Chw         , Chw         , Chw         , Chw         , Chw         , Wo          , Wo          , Wo          , Wo          , Wo          , Wo          , Wo          , Wo          , Wo          , Wo          , Wo          , Wo          , Wo          , Wo          , Wo          , Wo          , Wo          , Wo          , Wo          , Wo          , Wo          , Wo          , Wo          , Wo          , Wo          , Wo          , Wo          , Wo          , Wo          , Wo          , Wo          , Wo          , Wo          , Wo          , Wo          , Wo          , Wo          , Wo          , Wo          , Wo          , Wo          , Wo          , Wo          , Wo          , Wo          , Wo          , Wo          , Wo          , Wo          , Wo          , Wo          , Wo          , Wo          , Wo          , Wo          , Wo          , Wo          , Wo          
